*****
S ***
*  **
**  *
* * *
*   *
** **
*  **
* * *
* * X
* * *
* * *
* * *
*   *
*****
