*********************
S+  *   *      *    *
***   *  * ***  * * *
* ** ** *     *  ** *
*   *   * * *  *    *
* *  **  *  * * *** *
*  *   *  **  *   * *
* * **  *  * * **   *
* *   * * *  *  * ***
* * * * *   ***   * *
*   * *  ******* *  *
***  ***    ***  ** *
*  *  *  **  *  *   *
* *** * **** * *  * *
*  ** *  *** * * *  *
**     *  *  *  *  **
*  * ** *  *  *   ***
**  *    *  **  *  **
* * ** * **   * **  *
*      *   **     * *
********X************
