*********************
S *    *    *       *
* * * *  ** * ** ** *
*  *    * * ** *  * *
* *  ***  *     * * *
*   *  **  ** * * * *
** ***   *   *  * * *
* * *  *  * ** *  * *
*     *** * *  * *  *
* * * **    * *   * *
*  * *   ** *  ** * *
**   * ** *  *  * ***
* * *  *  * * * *   *
*  *  * * *   * * * *
**   *      **  *** *
* * *  * *** * *    *
*    **      *  * * *
** *   * ****  *  * *
*   **  *    * ** * *
* *   *   **      * *
*X*******************
