*******
S+* * *
*    *X
*** * *
*  ** *
**    *
*******
