*******
S+* * *
*     X
*** * *
*  ** *
**    *
*******
