***************************************************************************************************
S+ *  *     *      * *      * * * *  * *    ** *      **  *                 *             *   *   *
**  *  ** *  * ** *    ** **       *    * *     ** **   * * ** ** ***** * *  * * * ****** * *   * *
* *  *  *  * *  *   * * *  * * ***  * *  *  * * *  * ** *   **  **     ** * **  ***     * *  * *  *
*  *  *   *   *  *** *  ** *  *   *   **  * * *  * *     * *   *   ***   *    *  *  ** **  * * * **
**  * * * * *  *      *  *  *   * ****  *  *  * *  *** *  *  **  **  ***  ***  * * * *   *  *  *  *
* *   * *  ***  *****  *  *  ****      * *   *  **    ***   *   *  *    * *  *   * *  **  *   *  **
* * **   *  * *      *   *  *    ** * *   * * *  ** *    ***  *  *  * ***  *  ***  * *   * ***  * *
* *  * * * *   ***** * *  * ** *     *  * * *  *   *  * *    *  * *   *   ***   * *  * **      ** *
*  *  *  *   * *   * *  * *    *****   ***   *  ** * *  * *** **  * * * ** *  * *   ** *  *** **  *
**  * *** ***  * * * ***  * ***    * * *** * * *   *  * * *      *  * *  *   *  * **   * *   *   **
** *          *  * *    *  *  * ** ***  *  **  * ****  *  ** * *  **   *  * * * *  * * * * **  *  *
*   ** ***** *  *   ***  * ** *  *    *** *   *  * *  *  *   * ** *  *  * **    * *  * *   *  *** *
* *  **     *  *  * * * **  *  * ** *     ** *  *    * *  * *   *  *  * *   ** *   *  * **   * ** *
* * *   *** * *  *    *   *  * *  *  *** * *  * * * **  *   * * * *  *  ***  *   *  *   * ***     *
* **  **  *    *  ***  **  *    *  **   *   * * **   * * * * ***  **  * *  *  * * *** *     * * ***
*    * * ******** *   *   * * * ** *  **  *      * * *    *   *  * ** *   * *  *     *** ** *  *  *
* * *     *    ** * **  * *   **   * * * * ******  *   ***  *   *   *  **   * *  * *  *    * *  * *
*  *  * *** **    * * * **  **   *** *   *        * * *    * * * ** * * ** *  * *   *   * *    *  *
* *  ***    ******  * *   *  * **    * *** ***** *   *  * *   *       *  * * *  ***  * * ** ***  **
*   * *  *** *    * *  **  **  *  ****    *      * *   * *  *   ** *** * * *  *   * * *         * *
*** * * **     * *  ** * * *  ***     ***  * ** **  ***   *  ***  *        **  **  *    * *** *   *
* * * * *  ** *  * * *   * * ***  ** *  * **  *   *   ***  *     *  * * * *  *   * * ** ** * *** **
*     * * *   * **   * * * *  *  *   * **   *  * *  *   **   * *  ****  ** *  ** *     *      *   *
* *** *  *  **  * **   * *  * * * **     **  * **  * **   * *** *   *  *   **  *  *****  ** * *** *
**   *  *  * **   * ***  ** * * *   ****   * *    *   * *  ***   **  *   *    *** *     * * *   * *
** *   ** **   ** *   * * * * * ** *    * **  * **  *  * *  *  *   *  **  * *  *  * * **     ** * *
*  ****   *  *    ** **   *   *    * * **   * ***  ***    *   ****  *   **   *  * *  *  *****    **
* *   * **  * * **     * * ***** **  *  * * *     * * * ** * * *  * ***   ***  *  **   *     ***  *
*   * *  **    *   ****       **  * * *  **  * * *    *    ***   **   * *    * * *   * * ***   ** *
** **  *   * *   * *    * ** *   *  *  *    * * *  **  ***    ** * ** * **** * *   ** *  *  **  * *
*  * *  ** ** **  *  * *    *  **  * *  *** *   * *** *   * * *     *  *     * ****    *  * *  *  *
**    *  *     ***  *** ****  ** *   **   *  * **  *   **  *  * * *  *   ** *      * *  * *  * * **
* *** ** *** *     ***     * *    ** *  *  * *   * * * *** * *  **  ******   ***** **  *  **     **
*   *  *    * ****  *  ***   * *** *  * * **  * ** * *  *  *  *   *  *     **    *   *  * * * ** **
* *  *  ***       *  * *  ****  *   * * *    *  *  * ** * *  *  * **  * ***** **  ** * **    ***  *
*  * **   ******* ***  **     *   * * *  * **  *  **  *   * * * *   * * *  *  * *  *   * ***  *  **
* **  ***    *  *     *  * ** ****  * ***  *  *  *  * * **  *   ***  *  * ** *   *  **   *  *  *  *
* *  *   *** **  * ***  *   *     * *    *   *  *  *   *   * * *   *   *  *  * *  *   **   * * ** *
*  **  *   *   *  **   *  * ** **   ****  ** * *  *  **  **  *  * *** * * * *  ** ***   **   *  ***
**    *  *  **  *    *   **   * * * *   *   *  **  *   *  * *  *   * *    *  * ***   ** * **  *   *
*  **** * *  * *  * *****   * *  *  * ** **  *  **  **   *  * * **     **  * *  *  *  * *   **  * *
****    *   *  * *   *   ***  **  * *      * **   *   ***  *  *   *** * * **  *   *  *  * * *  ** *
*    ** * ** * **  * * *     *  * * *** * *     **  * *   *  ** * *   *     * ****  * *   *  * *  *
* * * **     *   ** *  * ****** *       *  *****   *  * * * *   *   ** * ****    * *   **  * **  **
*  *    *** * **    * * *    *  * *** *  *     ** ** *  *   * * ****    *    * * *  **   * *  * * *
** * **   *     *** *     **  *   *   ******* *   *  * ** **  **     **   **  *   *    *  * * * * *
*  *   ** * *** * * * ****  *  * *  **   *    * *  *  *     *    ***** ****  *  * *** * *   * *   *
* * **  *  *    * * *  *   ***  *  *   *  * **  **  *  * * *  ****          *  * *   *   * **  * **
*   *  * *  * **  * **  * *** * * *  *  * * *  * * * *  ** * *     * *** ** **   * * * ***   *   **
* * * *   * *    *    *   **  * * * * * * **  *  *    * *  *** **** *   * *   ** * * * *   *  **  *
* *** * * *  * **  * *  **   *  **  *   *  * ***  * **  * *    *      *    * * *   * * * **  * * **
*     *  * * *  * * *  *   * * *   * * * *   *** *  *  *    ***** ***  * **  *  **** * * *  *  *  *
* ** * *   *  * * *   ** **    * **   *   *** *   *  *  ****      *  * **   ** **    *    *   *  **
*   *    ** *  **  * *    **** * *  *   * *     * **  * *   * * ** *    * **   *  ***  ** ** *  * *
* **  * *   ** * *  *  ***   ***  **  ***  *** *   * ** * **  *    * ****   * *  *    *  *   ** * *
*   **  * *  *   * *  *    *    *  * *   *     * **  *  *    *  **  **   * ** * * * *   *  * *  * *
*** ** *   *  * *  * *  *** ** * * * ***  ** *  * * * *  ****  *  *    *      *    *  * * * *  *  *
*      * * **   * *   * *    *   * *    *   *  *    *  * *   **  *  **  *** *  ***  ** *    * ** **
* ** *** *   * *  * *   * **   * * * ** * *  * * *** *     *   *   *  **  ** * *  * *   ** **     *
*   *    ** * *  * *  **  *****  *  *** *  *   *      * * * ** * ** *    *   *   *  * * *    **** *
* **  ** * *    *   *   *  *  * ***  *  * * *** *****  ** *  * * *   * **  *  **  * * * * **    * *
**   **    * * ** * * * **  *    *** * *    *        *   *  *  * * **  *  * *   * *   * * * ** ** *
*  **   * *  **   *  **   *  ***  *  *  ***  * ** *** **  *   *  *    *  *  ***  *  **  *    *    *
* ******  * *   *  *    ** *    **  * * * **  *   *   * * * **  * * **  * *    * * *   * *** * ****
*  **   **  ******  * **   ** *  * *    *   * * **  *   * * ***   *   * *   ** *  *** **   *  *   *
**    * *  *    * *  * * *   * * *  ***  * *  * *  ** **  *  * ** * * *  * ***  *  *  *  *   *  * *
*  ****  *   **    * * *  ** *    *  *  *  * *    *   *  *  *   * * *  * * **  *  *  *  *****  *  *
* *    *  ***  *** *    *  *   **  *  * * **  **** * ** * * * * * ** * *  *   * * * * *  *    * * *
*  ** *  **  *   * *******  ***  *  * * *   * *      *  *   *  *     * * *  **  * * *  * *** *   **
**    **    *  * *      *  *    *** * * * **    * ***  *  ****   * *   *  *   * * *  *     *   *  *
* ***   * **  *  ******  *  * *  *  *   * *  ** **    ** *  *  * ** **  * * *   *  * * ***  * *** *
*    ** *    *  *      * * *  * *  * **** * *  *   ***   * ** * *    * *  *  * *** *  *  **  * *  *
* * * * *** *  *  ** * * *  ***   *  *    * ** * ***  * *  *    * **  *  * * *  **  *  *    *   * *
* *       *  *  * *  * *  *    * * * * * **  *   *   *  **   * *  * *  * * * **   * ** * ***  *   *
* * ***** **  * *** *** * * ** *     * *    ** *** *  *  * ** *  *  **   *     ** *  * * *  *  ** *
*  *    *   * *     **  * *  * * ****   ****   *    * * *  *    * *   ***  ** *    *   *  *  *  * *
** * **  ***  *** *    **  * *  *     **     *  * *  *  * *  ***  ***     ** *  **  * * *  *   *  *
** *   * *   *  ** * *   *  * * * * ***  ** * **   **  *  **     *   * ***     *  *  *   * * *  * *
*  * * *   ** *     * * * *   *    *    *  *     *    *  * ***** * *  **   ****** ** * *   *  * * *
* * *  *****    * *   * *  ** ****** *** * * ** * ** *** *     *    * *  ***   **    *  *** * *  **
* *  * *     ****  ****  *  *        * *   * * *    ***  ** *** *** * * *    *    ***  *      **  *
* ** * * *****   *    * ** * *** ****   * *  *   **  *  * *        *  * *** *  * *   *  * ** *   **
*    * * *     *  *** *      *  *     *   * *  ***  *  *  * ** *** * *     *  * ** *  *  ****  *  *
* * *  *  ** **** * *  *****  *   * ** * **  *    **  * *   *  *   *  ** *  * *    * * *  *** *  **
* **  ***  * * *    **     ** * *  *   * *  ** **   * *  * * * ** * * *  **  *  ****    *  *  **  *
*  * * *** * *   **  *****     * *   * *  *   *   * * ** * * *   *  *  *   *   **  * **  *   *  * *
** *    *  *  ***  **     * **    ***  **  ** * * * *  *     ***   * *  **** *    ** * *  * *  *  *
**  *** * * * *   *   * * ***** **   *   *  *  *  *  * * ** *    * *  *     * ****   *   * * * * **
* *   * *     * * * ** **   ***    * *** * * *  * * **  **  * ** *  *  **** *      **  **      *  *
*   * *  * * *  * * *    **  * * ***    *  *   *  *   *   **  * ** *  *   *  * * ** * * * * *** * X
* * * ** *  *  ** * * ** * * *  *   *** ** * ** * ***  ** *  *       *** * * *  *   *   * *     * *
*  *   * * *  **  * *  *   * * *  * * *    *     *   * *   * * *****       *  *  **  * *  * ** *  *
* *  **   *  *   **  * * *   *  * *     *** ****   * *   *   **     ** ***  *  *   *   * * *   * **
**  * * * * *  **  * * *  * * *    ****         * ** * ** * *   ***   *   *  *  **  * *    * * *  *
*  *  *  *   *    ** *  *  *   *** *   ** *** ** *    *   **  **   **   *  *  * * *  ** ** *  *** *
**   * * * *  ** *    * ***  *    ** *   *   *    * **  *    **  * *  *  *  **  * **     ** * **  *
*  *   *    *  *   ** *     *  **     **   *   **      *  * *   *    ***  *    *     * *    *    **
***************************************************************************************************
