*********************
S+*   *     *     * *
* * *  * * *  * * * *
* *  *   *  * * *   *
*   ***** * * * * * *
******    *  *  * * *
*   *  * *  *  * *  *
* * * *   * * *   ***
* **  * *   *   *   *
*    * *****  * * * *
* * *   *   **   *  *
**  * *   *   **** **
*  *  ** * **      **
* *  *   *   *****  *
*  **  ** **      * *
**   *  *    * * *  *
* ** * ** *** **  * *
* *  * *  *     * * *
* * ** * *  ** *  * *
*      *   *    *   *
*****X***************
